region;subregion;eligible_voters_19;eligible_voters_14;voters_19;voters_14;invalid_19;invalid_14;valid_19;valid_14;afd_19;afd_14
Flensburg, Stadt;1,0;70431;70929;39647;25350;237;176;39410;25174;2477;1583
Kiel, Landeshauptstadt;1,0;186195;188135;109595;75741;577;405;109018;75336;6459;4418
Lübeck, Hansestadt;1,0;166530;167198;90946;62933;461;424;90485;62509;6773;4334
Neumünster, Stadt;1,0;60215;60970;29036;27659;231;409;28805;27250;2761;1960
Dithmarschen;1,0;107045;107804;58244;42819;475;469;57769;42350;5121;2325
Herzogtum Lauenburg;1,0;152666;150105;91899;69625;609;588;91290;69037;8355;5182
Nordfriesland;1,0;131877;130887;77635;53913;446;419;77189;53494;4373;3038
Ostholstein;1,0;165528;165120;96712;70141;723;618;95989;69523;7752;5439
Pinneberg;1,0;239300;236519;150689;108214;1005;784;149684;107430;11681;7628
Plön;1,0;105085;104325;66925;48942;424;374;66501;48568;4846;3390
Rendsburg-Eckernförde;1,0;218614;216954;136614;99710;793;765;135821;98945;9206;6678
Schleswig-Flensburg;1,0;159674;156854;95525;66056;618;519;94907;65537;5705;4273
Segeberg;1,0;212630;209166;126584;88572;766;606;125818;87966;10296;6364
Steinburg;1,0;104839;105504;60505;44391;387;382;60118;44009;4675;2563
Stormarn;1,0;188732;186619;123481;94016;617;759;122864;93257;9778;6934
Schleswig-Holstein;99,0;2269361;2257089;1354037;978082;8369;7697;1345668;970385;100258;66109
Hamburg, Freie und Hansestadt;2,0;1302548;1283323;805905;558277;9473;5406;796432;552871;51649;33239
Hamburg;99,0;1302548;1283323;805905;558277;9473;5406;796432;552871;51649;33239
Braunschweig, Stadt;3,0;190413;194345;122195;99682;573;1050;121622;98632;8329;5550
Salzgitter, Stadt;3,0;72737;75270;37215;34611;393;483;36822;34128;5519;1976
Wolfsburg, Stadt;3,0;89191;92913;50390;38340;324;254;50066;38086;5105;2512
Gifhorn;3,0;136223;134817;82780;64411;507;597;82273;63814;8047;3108
Goslar;3,0;107632;112117;62885;43027;495;290;62390;42737;6409;2905
Helmstedt;3,0;73182;74543;42754;31577;326;284;42428;31293;3895;1688
Northeim;3,0;107594;110332;60355;53172;361;561;59994;52611;4877;2894
Peine;3,0;103605;102763;64184;48159;418;400;63766;47759;5936;2520
Wolfenbüttel;3,0;96324;97307;62070;51152;402;456;61668;50696;5512;3174
Göttingen;3,0;253354;257883;152703;129655;745;1196;151958;128459;10309;6451
Region Hannover;3,0;844533;850194;540175;413626;2752;3664;537423;409962;43422;23741
Diepholz;3,0;169375;168403;105348;83526;681;707;104667;82819;7850;4320
Hameln-Pyrmont;3,0;116288;118875;67945;58476;413;633;67532;57843;6648;3518
Hildesheim;3,0;217020;219042;135482;106129;663;841;134819;105288;11272;5842
Holzminden;3,0;55950;58035;33503;27290;372;349;33131;26941;2759;1277
Nienburg (Weser);3,0;94437;95424;53561;41146;352;288;53209;40858;4601;1908
Schaumburg;3,0;124384;125366;72992;63465;399;594;72593;62871;6544;3665
Celle;3,0;139021;139565;83672;64929;435;485;83237;64444;9096;5119
Cuxhaven;3,0;158334;158271;97886;72992;832;522;97054;72470;7845;3501
Harburg;3,0;199955;195893;132929;102313;828;1070;132101;101243;11358;9038
Lüchow-Dannenberg;3,0;39160;39602;23088;20974;147;280;22941;20694;1710;1028
Lüneburg;3,0;142507;139750;95397;74254;666;740;94731;73514;7151;4411
Osterholz;3,0;90731;89145;56826;44314;310;354;56516;43960;4550;2538
Rotenburg (Wümme);3,0;129318;128196;80401;71135;456;669;79945;70466;5814;2990
Heidekreis;3,0;108608;109018;64342;55676;406;664;63936;55012;5766;3020
Stade;3,0;157508;155555;98083;74562;593;620;97490;73942;8245;4572
Uelzen;3,0;74964;75619;46290;37733;375;332;45915;37401;4038;2226
Verden;3,0;105973;104680;68058;55868;498;435;67560;55433;5242;2915
Delmenhorst, Stadt;3,0;56279;57777;29611;25765;259;368;29352;25397;3480;1645
Emden, Stadt;3,0;37967;38973;22907;14006;333;123;22574;13883;2134;661
Oldenburg (Oldenburg), Stadt;3,0;129795;126358;84221;59915;388;338;83833;59577;4379;3320
Osnabrück, Stadt;3,0;123608;120658;79178;61488;393;501;78785;60987;3780;2530
Wilhelmshaven, Stadt;3,0;61706;64170;32937;24125;315;219;32622;23906;3021;1662
Ammerland;3,0;97566;95337;63255;46951;463;569;62792;46382;4419;2960
Aurich;3,0;153372;152222;92401;77325;1377;1502;91024;75823;8282;3358
Cloppenburg;3,0;120227;117936;66148;59731;407;643;65741;59088;4903;2187
Emsland;3,0;239069;236116;150178;121346;991;843;149187;120503;8120;3703
Friesland;3,0;81384;80352;50517;39529;527;579;49990;38950;3873;2331
Grafschaft Bentheim;3,0;97968;97142;65766;49591;427;294;65339;49297;3088;1361
Leer;3,0;131488;129177;73354;63222;640;1117;72714;62105;6572;3287
Oldenburg;3,0;101026;99395;63567;54677;287;534;63280;54143;4914;3321
Osnabrück;3,0;272973;271647;171071;143832;1109;1134;169962;142698;9553;5135
Vechta;3,0;101152;99942;65089;51475;367;415;64722;51060;3927;1793
Wesermarsch;3,0;69579;70534;37953;29868;294;305;37659;29563;2973;1614
Wittmund;3,0;46072;45632;24414;21812;232;315;24182;21497;2118;1067
Niedersachsen;99,0;6119552;6126291;3766076;3006852;24531;28617;3741545;2978235;297385;160342
Bremen, Stadt;4,0;390038;400711;254481;166340;3115;1159;251366;165181;17977;9512
Bremerhaven, Stadt;4,0;80172;83017;41806;28689;812;307;40994;28382;4473;1693
Bremen;99,0;470210;483728;296287;195029;3927;1466;292360;193563;22450;11205
Düsseldorf, Stadt;5,0;414530;415747;263153;223845;1417;2483;261736;221362;18079;12533
Duisburg, Stadt;5,0;325373;336313;162888;143261;1549;1944;161339;141317;19359;10157
Essen, Stadt;5,0;416106;428584;246269;203073;1877;2118;244392;200955;26304;12010
Krefeld, Stadt;5,0;162065;165558;93883;79988;776;1143;93107;78845;7248;4623
Mönchengladbach, Stadt;5,0;188522;192506;103352;86904;982;1377;102370;85527;8868;4374
Mülheim an der Ruhr, Stadt;5,0;123207;125981;77168;65994;572;916;76596;65078;7396;4724
Oberhausen, Stadt;5,0;150624;155439;82902;70811;851;1230;82051;69581;10010;4090
Remscheid, Stadt;5,0;77129;79005;43470;36218;455;583;43015;35635;4254;2108
Solingen, Klingenstadt;5,0;112713;113987;64681;53495;496;718;64185;52777;5869;3109
Wuppertal, Stadt;5,0;238998;245963;140535;118361;1050;1352;139485;117009;13628;7052
Kleve;5,0;227070;227084;136898;119292;1125;1825;135773;117467;8693;5358
Mettmann;5,0;367255;370957;234389;201473;1810;2714;232579;198759;20603;13114
Rhein-Kreis Neuss;5,0;334970;334173;211310;175598;1588;1986;209722;173612;16801;9916
Viersen;5,0;228023;228136;141515;120707;1125;1612;140390;119095;9873;6179
Wesel;5,0;356669;360478;218516;190119;1807;3004;216709;187115;19658;9844
Bonn, Stadt;5,0;228055;227483;158398;136146;748;1592;157650;134554;9418;7848
Köln, Stadt;5,0;740448;729081;478587;387748;2527;3759;476060;383989;29372;21176
Leverkusen, Stadt;5,0;116207;117710;69726;57450;580;736;69146;56714;6510;3768
Städteregion Aachen;5,0;405298;408743;249038;222895;1758;3265;247280;219630;17064;8806
Düren;5,0;199697;200004;120531;107570;1259;1814;119272;105756;11541;5533
Rhein-Erft-Kreis;5,0;346326;345437;220996;180617;1807;2557;219189;178060;20340;9048
Euskirchen;5,0;151478;148868;92833;78817;889;1278;91944;77539;8877;4409
Heinsberg;5,0;191077;189213;112550;102648;1176;2100;111374;100548;9358;4404
Oberbergischer Kreis;5,0;207897;209600;126841;113900;1184;1703;125657;112197;11601;6387
Rheinisch-Bergischer Kreis;5,0;218103;217229;148330;125455;866;1233;147464;124222;10646;7633
Rhein-Sieg-Kreis;5,0;455483;449917;300253;262151;2237;3395;298016;258756;24211;15145
Bottrop, Stadt;5,0;87999;89473;52298;44529;495;590;51803;43939;6387;2472
Gelsenkirchen, Stadt;5,0;172667;180811;88496;81747;853;1420;87643;80327;14398;6131
Münster, Stadt;5,0;234502;230294;172718;142460;653;1174;172065;141286;6883;5819
Borken;5,0;278982;276875;181446;155070;997;1902;180449;153168;9778;5204
Coesfeld;5,0;173128;171164;120049;102969;643;1050;119406;101919;6513;3782
Recklinghausen;5,0;469806;479057;274015;236191;2259;3756;271756;232435;31144;12918
Steinfurt;5,0;340622;338268;221206;194990;1366;2730;219840;192260;12331;6251
Warendorf;5,0;209212;210359;135952;120687;923;1678;135029;119009;9035;4738
Bielefeld, Stadt;5,0;237243;238932;151344;127375;1114;1609;150230;125766;11498;6272
Gütersloh;5,0;263291;262976;164120;141757;1124;2150;162996;139607;12505;6716
Herford;5,0;191048;193351;113252;102072;865;1621;112387;100451;11158;5766
Höxter;5,0;111469;113628;69376;65911;603;1239;68773;64672;5650;2924
Lippe;5,0;267750;271166;164091;146244;1464;2445;162627;143799;15680;7894
Minden-Lübbecke;5,0;240181;243588;141876;123748;1074;1974;140802;121774;12816;6437
Paderborn;5,0;230946;227655;139286;119851;994;1606;138292;118245;11131;5932
Bochum, Stadt;5,0;271416;279538;165855;140112;1364;1803;164491;138309;15598;7878
Dortmund, Stadt;5,0;412595;420999;241207;199861;1679;3146;239528;196715;22013;11693
Hagen, Stadt der FernUniversität;5,0;130560;135884;72691;65301;641;1037;72050;64264;9077;4058
Hamm, Stadt;5,0;125696;127995;72575;68038;601;1365;71974;66673;7847;2980
Herne, Stadt;5,0;110657;114782;59376;50556;647;792;58729;49764;7776;3224
Ennepe-Ruhr-Kreis;5,0;251943;256497;156316;134030;1202;1781;155114;132249;14231;7832
Hochsauerlandkreis;5,0;201504;205528;125070;113822;808;1772;124262;112050;9206;5111
Märkischer Kreis;5,0;302136;311957;170134;146283;1480;2116;168654;144167;16988;9394
Olpe;5,0;102295;103744;64922;56226;454;683;64468;55543;4728;3278
Siegen-Wittgenstein;5,0;211301;215420;130012;115233;983;1717;129029;113516;13427;7179
Soest;5,0;232462;232293;140546;123332;875;1794;139671;121538;11331;6002
Unna;5,0;304843;309601;181778;158808;1557;2336;180221;156472;17690;8491
Nordrhein-Westfalen;99,0;13149577;13265031;8069019;6941739;60229;95723;8008790;6846016;682400;369724
Darmstadt, Wissenschaftsstadt;6,0;107437;105493;71045;51129;410;439;70635;50690;4569;3451
Frankfurt am Main, Stadt;6,0;429856;418278;258304;186201;1371;1446;256933;184755;17316;14716
Offenbach am Main, Stadt;6,0;67788;66880;34927;24839;320;319;34607;24520;3500;2344
Wiesbaden, Landeshauptstadt;6,0;188034;189820;111027;78728;975;643;110052;78085;9667;7161
Bergstraße;6,0;198695;200057;120229;90704;1364;1519;118865;89185;13356;7904
Darmstadt-Dieburg;6,0;215429;213600;136397;97400;1647;1456;134750;95944;12508;7940
Groß-Gerau;6,0;176014;175171;100854;73713;1180;1148;99674;72565;10435;6600
Hochtaunuskreis;6,0;164348;165167;107046;83370;636;799;106410;82571;9165;8896
Main-Kinzig-Kreis;6,0;299123;300763;168204;120109;1925;1847;166279;118262;20729;12553
Main-Taunus-Kreis;6,0;165816;166024;106307;82454;826;920;105481;81534;9479;9551
Odenwaldkreis;6,0;70869;72044;39925;31232;598;618;39327;30614;4560;2852
Offenbach;6,0;238715;239582;142756;103416;1431;1338;141325;102078;14225;9763
Rheingau-Taunus-Kreis;6,0;138642;138630;89677;64250;930;745;88747;63505;8663;6097
Wetteraukreis;6,0;225720;224655;131970;90437;1423;1032;130547;89405;13745;8898
Gießen;6,0;200804;198130;115449;81310;1061;1018;114388;80292;11064;6914
Lahn-Dill-Kreis;6,0;189854;192664;99745;64892;1108;723;98637;64169;11847;5574
Limburg-Weilburg;6,0;128963;130500;71311;50251;781;581;70530;49670;7821;5053
Marburg-Biedenkopf;6,0;183183;185360;104228;72844;689;765;103539;72079;9621;5397
Vogelsbergkreis;6,0;84549;86636;47658;36194;647;706;47011;35488;5823;3369
Kassel, documenta-Stadt;6,0;140438;142751;77652;57059;663;592;76989;56467;5747;4560
Fulda;6,0;169880;169360;97074;66281;1004;837;96070;65444;12312;5860
Hersfeld-Rotenburg;6,0;93123;96421;51375;37534;671;509;50704;37025;6717;3651
Kassel;6,0;188527;190823;106538;78845;1478;1485;105060;77360;10021;7277
Schwalm-Eder-Kreis;6,0;142375;145071;79752;62701;1114;1549;78638;61152;8703;5466
Waldeck-Frankenberg;6,0;122990;126068;64235;46887;627;582;63608;46305;6481;3663
Werra-Meißner-Kreis;6,0;80896;83046;45003;35088;656;698;44347;34390;4720;2996
Hessen;99,0;4412068;4422994;2578688;1867868;25535;24314;2553153;1843554;252794;168506
Koblenz, kreisfreie Stadt;7,0;83969;84878;51017;41846;542;535;50475;41311;3736;2741
Ahrweiler;7,0;101203;100539;66724;57741;883;1104;65841;56637;5224;4093
Altenkirchen (Westerwald);7,0;100084;101504;60892;56088;954;1191;59938;54897;5820;3386
Bad Kreuznach;7,0;120062;121149;76655;70980;1389;1708;75266;69272;7705;4583
Birkenfeld;7,0;63925;66293;37437;35126;846;1070;36591;34056;3964;2209
Cochem-Zell;7,0;48692;49773;33505;31627;784;1018;32721;30609;2504;2100
Mayen-Koblenz;7,0;166494;166771;103595;92494;1666;1977;101929;90517;8675;5467
Neuwied;7,0;138233;138629;85529;75190;1172;1394;84357;73796;7703;5476
Rhein-Hunsrück-Kreis;7,0;80638;81316;54996;50220;1040;1287;53956;48933;4763;2751
Rhein-Lahn-Kreis;7,0;94896;96743;62471;56918;1132;1365;61339;55553;5778;4180
Westerwaldkreis;7,0;154465;154995;100878;91273;1719;2303;99159;88970;9443;5578
Trier, kreisfreie Stadt;7,0;80431;81791;48513;39723;495;550;48018;39173;3223;2298
Bernkastel-Wittlich;7,0;86098;87851;56022;52323;1166;1698;54856;50625;4197;2642
Eifelkreis Bitburg-Prüm;7,0;72189;73408;50043;46126;1222;1659;48821;44467;3355;1989
Vulkaneifel;7,0;47996;48766;30759;29543;673;990;30086;28553;2180;1544
Trier-Saarburg;7,0;112648;112654;79057;69308;1456;2046;77601;67262;5364;3747
Frankenthal (Pfalz), kreisfreie Stadt;7,0;33348;34215;19034;16468;339;299;18695;16169;2532;1322
Kaiserslautern, kreisfreie Stadt;7,0;71365;73674;38987;32162;556;498;38431;31664;4622;2088
Landau in der Pfalz, kreisfreie Stadt;7,0;36257;35005;24124;19137;268;321;23856;18816;1881;1369
Ludwigshafen am Rhein, kreisfreie Stadt;7,0;102451;104309;55399;46979;1145;869;54254;46110;7684;4449
Mainz, kreisfreie Stadt;7,0;150251;146148;102415;80511;898;906;101517;79605;5966;4777
Neustadt an der Weinstraße, kreisfreie Stadt;7,0;40621;41441;26537;22844;318;359;26219;22485;2611;1400
Pirmasens, kreisfreie Stadt;7,0;30963;32144;15433;14448;375;393;15058;14055;2245;886
Speyer, kreisfreie Stadt;7,0;36237;36768;21948;18433;274;263;21674;18170;2278;1266
Worms, kreisfreie Stadt;7,0;58080;59521;32205;29072;544;632;31661;28440;3942;2212
Zweibrücken, kreisfreie Stadt;7,0;25997;26888;13706;11738;230;243;13476;11495;1583;827
Alzey-Worms;7,0;98159;97080;66606;59159;1238;1640;65368;57519;8168;4480
Bad Dürkheim;7,0;104795;104828;73282;63248;1087;1388;72195;61860;8223;4452
Donnersbergkreis;7,0;58275;58725;38700;34773;755;964;37945;33809;4742;2381
Germersheim;7,0;94398;94277;62054;54520;1065;1262;60989;53258;8686;4122
Kaiserslautern;7,0;81200;81706;54712;50296;1293;1538;53419;48758;6906;3060
Kusel;7,0;56613;58242;37705;35735;958;1235;36747;34500;4989;2121
Südliche Weinstraße;7,0;87144;87691;62279;55485;1194;1574;61085;53911;6541;3790
Rhein-Pfalz-Kreis;7,0;117009;116626;80643;69431;1142;1318;79501;68113;9531;5708
Mainz-Bingen;7,0;158871;157364;112369;98591;1497;1933;110872;96658;9302;6066
Südwestpfalz;7,0;78708;80182;55974;53610;1495;2172;54479;51438;6785;3042
Rheinland-Pfalz;99,0;3072765;3093894;1992205;1763166;33810;41702;1958395;1721464;192851;114602
Stuttgart, Landeshauptstadt;8,0;380985;378862;255470;201380;2172;1725;253298;199655;18876;14887
Böblingen;8,0;262708;258396;173851;138646;2542;2146;171309;136500;17562;12193
Esslingen;8,0;365828;363627;242055;195920;3565;3058;238490;192862;22958;14586
Göppingen;8,0;178436;179093;111874;90071;2128;2101;109746;87970;13732;7571
Ludwigsburg;8,0;365970;363677;244616;198535;3596;3283;241020;195252;23909;16232
Rems-Murr-Kreis;8,0;297477;296116;193131;156642;2913;2749;190218;153893;21895;15467
Heilbronn, Stadt;8,0;77185;78309;42835;33272;636;503;42199;32769;5495;2793
Heilbronn;8,0;242435;239085;155172;123791;3401;3266;151771;120525;19561;10041
Hohenlohekreis;8,0;82480;82285;51822;42348;857;988;50965;41360;6074;2930
Schwäbisch Hall;8,0;143275;141514;86854;68197;1594;1883;85260;66314;9753;4771
Main-Tauber-Kreis;8,0;101414;103283;67155;59300;1544;1809;65611;57491;7056;3894
Heidenheim;8,0;93726;95219;54670;44594;1144;983;53526;43611;5471;3252
Ostalbkreis;8,0;231322;230415;145645;116074;3025;3228;142620;112846;14234;7846
Baden-Baden, Stadt;8,0;38487;39257;23731;18657;328;273;23403;18384;2235;1665
Karlsruhe, Stadt;8,0;209516;207006;135402;101277;1346;1071;134056;100206;10787;7961
Karlsruhe;8,0;323238;323232;209814;173398;4275;4865;205539;168533;23146;14325
Rastatt;8,0;167254;167850;103779;83628;2644;2723;101135;80905;11743;7112
Heidelberg, Stadt;8,0;100384;98268;70400;53822;535;452;69865;53370;4303;3611
Mannheim, Universitätsstadt;8,0;199916;200318;116585;88285;1484;1317;115101;86968;12287;8437
Neckar-Odenwald-Kreis;8,0;108354;109800;68991;59582;1675;1963;67316;57619;7940;3822
Rhein-Neckar-Kreis;8,0;399897;399656;263457;216540;5367;6007;258090;210533;27721;18401
Pforzheim, Stadt;8,0;75907;77938;40419;29737;793;519;39626;29218;6995;4232
Calw;8,0;112394;110858;71274;57453;1213;1381;70061;56072;9387;5761
Enzkreis;8,0;143293;142528;94043;76435;1604;1947;92439;74488;11985;8538
Freudenstadt;8,0;86400;86824;53081;44445;1045;1111;52036;43334;6600;3479
Freiburg im Breisgau, Stadt;8,0;157789;155449;106346;85548;946;830;105400;84718;5586;4825
Breisgau-Hochschwarzwald;8,0;193103;190289;130008;109276;2824;2788;127184;106488;9638;7879
Emmendingen;8,0;123701;121857;81001;65600;1839;2025;79162;63575;6466;3822
Ortenaukreis;8,0;317094;316303;192979;161212;4389;5739;188590;155473;18858;11084
Rottweil;8,0;102914;103195;63538;53160;1374;1806;62164;51354;7203;4542
Schwarzwald-Baar-Kreis;8,0;149042;150541;87251;74092;1829;1988;85422;72104;8413;5925
Tuttlingen;8,0;95213;96043;57744;48601;1459;1640;56285;46961;6124;3386
Konstanz;8,0;205147;202911;129936;102839;2207;2225;127729;100614;10243;6970
Lörrach;8,0;161560;162717;97521;78919;1840;2032;95681;76887;8632;5303
Waldshut;8,0;119122;119139;73466;61692;1431;1672;72035;60020;6486;3800
Reutlingen;8,0;200184;199935;124190;100213;1742;2036;122448;98177;13140;8626
Tübingen;8,0;161993;158007;113120;91219;1230;1347;111890;89872;8199;6624
Zollernalbkreis;8,0;138389;139454;82245;68190;1733;2010;80512;66180;10153;5630
Ulm, Universitätsstadt;8,0;83482;82591;53462;41224;513;421;52949;40803;3798;2738
Alb-Donau-Kreis;8,0;140125;138961;93883;79911;1720;1956;92163;77955;9144;5221
Biberach;8,0;146207;143105;94008;77407;1817;2159;92191;75248;8583;4459
Bodenseekreis;8,0;158275;156520;105627;85430;1538;1558;104089;83872;8966;5630
Ravensburg;8,0;208837;206250;133795;106823;1981;2238;131814;104585;9979;5886
Sigmaringen;8,0;96823;96443;61177;51879;1304;1669;59873;50210;6120;3343
Baden-Württemberg;99,0;7747281;7713126;4957423;4015264;85142;89490;4872281;3925774;487436;309500
Ingolstadt, Stadt;9,0;91126;90683;48289;30667;173;100;48116;30567;5198;2648
München, Landeshauptstadt;9,0;928090;924005;607234;422743;952;950;606282;421793;36282;32869
Rosenheim, Stadt;9,0;41410;41596;23722;15629;65;51;23657;15578;2241;1696
Altötting;9,0;82914;82981;46301;30679;114;103;46187;30576;4051;2332
Berchtesgadener Land;9,0;75243;74848;43460;27428;152;108;43308;27320;3802;2193
Bad Tölz-Wolfratshausen;9,0;93112;92336;58996;40436;169;191;58827;40245;4547;4215
Dachau;9,0;105723;102640;68828;44674;166;122;68662;44552;5770;4079
Ebersberg;9,0;100417;97182;68997;46287;154;135;68843;46152;4798;4032
Eichstätt;9,0;98064;96247;62387;42483;167;137;62220;42346;6022;2846
Erding;9,0;99996;96834;63272;40820;181;166;63091;40654;5797;3725
Freising;9,0;121726;119723;77503;51944;193;247;77310;51697;6414;4998
Fürstenfeldbruck;9,0;155179;155035;104528;71977;239;205;104289;71772;7694;6591
Garmisch-Partenkirchen;9,0;65722;65622;41459;28061;152;92;41307;27969;3532;3079
Landsberg am Lech;9,0;90787;88105;60365;38543;139;112;60226;38431;4381;3125
Miesbach;9,0;73516;72572;47866;30495;123;106;47743;30389;3538;3052
Mühldorf a.Inn;9,0;85802;84607;48883;31554;136;113;48747;31441;5008;2730
München;9,0;238218;235289;168469;116090;326;360;168143;115730;11249;10247
Neuburg-Schrobenhausen;9,0;72036;70878;39960;29953;85;145;39875;29808;3669;2514
Pfaffenhofen a.d.Ilm;9,0;93530;91211;55817;39910;139;197;55678;39713;5752;3200
Rosenheim;9,0;195791;191063;123504;79735;281;248;123223;79487;10275;7391
Starnberg;9,0;97203;96460;69908;49854;120;126;69788;49728;4495;4499
Traunstein;9,0;134120;132926;79687;52553;210;157;79477;52396;6002;3544
Weilheim-Schongau;9,0;102661;100654;65600;44488;186;141;65414;44347;4847;4572
Landshut, Stadt;9,0;49256;48822;28802;18488;73;57;28729;18431;2552;1525
Passau, Stadt;9,0;38257;38468;22466;14490;55;48;22411;14442;1824;1156
Straubing, Stadt;9,0;34121;34667;17101;11029;68;51;17033;10978;1993;804
Deggendorf;9,0;91964;91418;47103;27570;109;93;46994;27477;5359;2348
Freyung-Grafenau;9,0;63757;63709;31715;16875;76;58;31639;16817;3627;1235
Kelheim;9,0;88551;87352;53127;32825;136;108;52991;32717;4731;2022
Landshut;9,0;118913;116297;73247;46391;176;127;73071;46264;7140;2885
Passau;9,0;150646;149285;79632;45962;185;162;79447;45800;8401;3625
Regen;9,0;62104;62610;29571;16498;74;69;29497;16429;3936;1501
Rottal-Inn;9,0;92148;91946;50147;30433;141;141;50006;30292;4664;2231
Straubing-Bogen;9,0;77829;76667;45784;30366;106;90;45678;30276;4828;1796
Dingolfing-Landau;9,0;71333;71650;38793;25503;107;92;38686;25411;4382;1648
Amberg, Stadt;9,0;32373;33217;16912;11512;68;38;16844;11474;1842;1096
Regensburg, Stadt;9,0;106300;103432;64366;41675;120;94;64246;41581;4576;3162
Weiden i.d.OPf., Stadt;9,0;32545;33246;17022;11551;61;46;16961;11505;1818;1216
Amberg-Sulzbach;9,0;81933;82522;49404;33538;168;153;49236;33385;4705;2365
Cham;9,0;102050;102140;54266;31749;125;137;54141;31612;6546;2192
Neumarkt i.d.OPf.;9,0;101502;99620;63990;42576;144;139;63846;42437;5406;2874
Neustadt a.d.Waldnaab;9,0;75822;76683;44479;31408;147;145;44332;31263;4367;2408
Regensburg;9,0;147691;146252;92345;61865;264;256;92081;61609;8832;4449
Schwandorf;9,0;114507;114360;63717;41070;184;163;63533;40907;7421;3001
Tirschenreuth;9,0;58961;60297;34674;24073;109;96;34565;23977;2914;1416
Bamberg, Stadt;9,0;55702;55010;33617;22127;93;81;33524;22046;2621;1550
Bayreuth, Stadt;9,0;57162;57280;32379;21750;74;83;32305;21667;2426;1757
Coburg, Stadt;9,0;31595;32359;17848;12559;57;33;17791;12526;1352;995
Hof, Stadt;9,0;33055;34221;16489;11294;54;54;16435;11240;1926;1075
Bamberg;9,0;116313;115598;70364;46669;177;190;70187;46479;7933;3186
Bayreuth;9,0;84304;85177;50453;34697;135;120;50318;34577;4269;2556
Coburg;9,0;69832;70794;40006;28104;112;100;39894;28004;3555;2053
Forchheim;9,0;90648;89698;57875;39835;143;130;57732;39705;4968;2874
Hof;9,0;76879;79214;43751;32049;124;132;43627;31917;4528;2381
Kronach;9,0;54955;56593;31142;21125;114;145;31028;20980;2896;1286
Kulmbach;9,0;58900;60402;33827;23288;105;87;33722;23201;3218;1915
Lichtenfels;9,0;53699;54645;30999;21779;108;83;30891;21696;3062;1525
Wunsiedel i.Fichtelgebirge;9,0;58033;60370;31669;22246;140;126;31529;22120;3428;1652
Ansbach, Stadt;9,0;30644;31263;16542;11331;68;46;16474;11285;1683;882
Erlangen, Stadt;9,0;77514;77383;51535;37320;113;88;51422;37232;3041;2473
Fürth, Stadt;9,0;86896;86007;49124;31368;172;145;48952;31223;4348;2542
Nürnberg, Stadt;9,0;342881;349601;201242;143804;590;811;200652;142993;17661;12070
Schwabach, Stadt;9,0;30044;30006;17944;12459;75;52;17869;12407;1508;1028
Ansbach;9,0;140434;139801;83057;55113;228;194;82829;54919;6957;3988
Erlangen-Höchstadt;9,0;103993;102993;69148;48417;183;154;68965;48263;5296;3671
Fürth;9,0;91862;90790;59550;40010;154;140;59396;39870;5563;3442
Nürnberger Land;9,0;130181;129375;84954;57895;220;233;84734;57662;7088;4275
Neustadt a.d.Aisch-Bad Windsheim;9,0;77458;77421;47420;33005;165;141;47255;32864;3787;2111
Roth;9,0;98021;97193;61851;41456;173;167;61678;41289;5260;2999
Weißenburg-Gunzenhausen;9,0;72142;72500;42249;29964;140;138;42109;29826;3206;2058
Aschaffenburg, Stadt;9,0;50032;49917;28272;17112;146;123;28126;16989;2517;1443
Schweinfurt, Stadt;9,0;37301;38947;18077;13598;83;91;17994;13507;2078;989
Würzburg, Stadt;9,0;98961;99770;62514;41643;150;133;62364;41510;3692;2895
Aschaffenburg;9,0;133359;134223;83199;53199;393;349;82806;52850;7486;4404
Bad Kissingen;9,0;83393;84410;50100;35211;177;177;49923;35034;4524;2347
Rhön-Grabfeld;9,0;63683;64780;37849;26640;151;135;37698;26505;2850;1370
Haßberge;9,0;68076;68335;41409;29204;141;119;41268;29085;3867;1396
Kitzingen;9,0;69339;69555;42702;30027;128;124;42574;29903;3447;1688
Miltenberg;9,0;95625;96324;57058;37507;281;222;56777;37285;4661;2355
Main-Spessart;9,0;99845;101181;63090;42611;237;201;62853;42410;4917;3342
Schweinfurt;9,0;91257;91692;57003;40853;198;209;56805;40644;5026;2708
Würzburg;9,0;127271;127059;86646;60414;259;250;86387;60164;5991;4124
Augsburg, Stadt;9,0;190297;188472;105747;68429;363;267;105384;68162;9421;7078
Kaufbeuren, Stadt;9,0;31409;31430;16454;11037;52;40;16402;10997;1676;1076
Kempten (Allgäu), Stadt;9,0;48801;48210;27480;17296;110;65;27370;17231;2545;1865
Memmingen, Stadt;9,0;29480;29910;16907;11160;95;54;16812;11106;1683;1231
Aichach-Friedberg;9,0;101054;98943;63818;40818;175;130;63643;40688;6036;4032
Augsburg;9,0;188792;185425;113784;74330;345;313;113439;74017;10529;7764
Dillingen a.d.Donau;9,0;72685;72224;39769;26453;109;103;39660;26350;4457;2060
Günzburg;9,0;90250;89371;48920;31431;139;117;48781;31314;5322;3264
Neu-Ulm;9,0;124023;122776;69347;45719;248;190;69099;45529;6965;4909
Lindau (Bodensee);9,0;60124;59362;37133;23694;120;101;37013;23593;2454;1616
Ostallgäu;9,0;106144;103730;65320;42411;195;173;65125;42238;4789;3412
Unterallgäu;9,0;108873;106402;64090;41387;174;210;63916;41177;6401;3961
Donau-Ries;9,0;100343;99971;59240;40570;172;159;59068;40411;4828;3146
Oberallgäu;9,0;119411;117420;76793;49173;244;186;76549;48987;5473;4031
Bayern;99,0;9547924;9503690;5801454;3886041;15920;14589;5785534;3871452;492443;311982
Regionalverband Saarbrücken;10,0;243243;251551;149551;121445;2471;2797;147080;118648;13599;8342
Merzig-Wadern;10,0;79282;81279;55222;49068;1303;1708;53919;47360;4792;2888
Neunkirchen;10,0;105049;109755;68364;56433;1516;1826;66848;54607;7115;3944
Saarlouis;10,0;153711;158330;103631;85962;2441;3022;101190;82940;9825;5532
Saarpfalz-Kreis;10,0;113837;117837;78970;67638;1649;2306;77321;65332;8556;4799
St. Wendel;10,0;72330;74441;53802;48723;1396;2036;52406;46687;4170;2743
Saarland;99,0;767452;793193;509540;429269;10776;13695;498764;415574;48057;28248
Berlin, Stadt;11,0;2508435;2519758;1520678;1177832;13321;18166;1507357;1159666;149177;91759
Berlin;99,0;2508435;2519758;1520678;1177832;13321;18166;1507357;1159666;149177;91759
Brandenburg an der Havel, Stadt;12,0;58801;60560;28624;22078;440;649;28184;21429;4909;1671
Cottbus, Stadt;12,0;78559;82908;45012;33305;717;732;44295;32573;10911;3175
Frankfurt (Oder), Stadt;12,0;44982;47810;22986;19836;341;451;22645;19385;4698;2482
Potsdam, Stadt;12,0;135094;128782;86270;63897;719;961;85551;62936;9322;4544
Barnim;12,0;151574;148233;88868;66884;1434;1571;87434;65313;17216;5429
Dahme-Spreewald;12,0;136836;134573;86332;68953;1639;2069;84693;66884;17545;6041
Elbe-Elster;12,0;86352;91556;51949;46495;1212;1957;50737;44538;12538;3226
Havelland;12,0;131243;127809;78129;58800;1091;1333;77038;57467;13798;5424
Märkisch-Oderland;12,0;159898;158572;95162;72311;1653;2075;93509;70236;19763;6227
Oberhavel;12,0;172533;169019;105536;79699;1600;1768;103936;77931;19441;7233
Oberspreewald-Lausitz;12,0;92588;98281;52558;45553;1167;1546;51391;44007;13596;3622
Oder-Spree;12,0;148367;150759;87721;74071;1583;2114;86138;71957;19212;7100
Ostprignitz-Ruppin;12,0;82700;84740;44207;35720;793;1036;43414;34684;7822;2323
Potsdam-Mittelmark;12,0;172790;168741;113815;89615;1823;2518;111992;87097;16468;6826
Prignitz;12,0;64169;67372;35814;28594;661;754;35153;27840;6730;1675
Spree-Neiße;12,0;96700;102604;59372;50375;1260;1832;58112;48543;17945;4634
Teltow-Fläming;12,0;135562;133945;81353;59484;1476;1679;79877;57805;15401;4921
Uckermark;12,0;99858;103892;54388;45439;1039;1518;53349;43921;11102;2818
Brandenburg;99,0;2048606;2060156;1218096;961109;20648;26563;1197448;934546;238417;79371
Rostock;13,0;168169;169595;101031;69529;1356;1319;99675;68210;12351;5278
Schwerin;13,0;75984;77683;44832;35046;530;675;44302;34371;6986;2476
Mecklenburgische Seenplatte;13,0;215869;223761;119010;102925;2513;3819;116497;99106;22803;6087
Landkreis Rostock;13,0;175793;177347;107583;85498;2118;2734;105465;82764;18147;5551
Vorpommern-Rügen;13,0;185938;190192;103257;85889;2437;3254;100820;82635;19721;6643
Nordwestmecklenburg;13,0;127880;129198;77174;62945;1722;2228;75452;60717;11945;4147
Vorpommern-Greifswald;13,0;193787;199588;111752;96207;2550;3710;109202;92497;23749;7254
Ludwigslust-Parchim;13,0;172741;177406;104441;91000;2239;3347;102202;87653;17503;5112
Mecklenburg-Vorpommern;99,0;1316161;1344770;769080;629039;15465;21086;753615;607953;133205;42548
Chemnitz, Stadt;14,0;193089;200626;120497;89204;1542;1580;118955;87624;27980;8508
Erzgebirgskreis;14,0;283006;299341;182031;154945;4611;5962;177420;148983;49827;16912
Mittelsachsen;14,0;251968;266103;161854;137384;3457;4679;158397;132705;45066;12489
Vogtlandkreis;14,0;189613;200127;115940;96630;2524;3140;113416;93490;27082;9510
Zwickau;14,0;264125;279269;159475;129666;3549;4069;155926;125597;37609;12066
Dresden, Stadt;14,0;428979;431526;294298;232079;2881;3648;291417;228431;57588;21693
Bautzen;14,0;249292;260686;162461;136092;4072;4573;158389;131519;50797;14230
Görlitz;14,0;209406;221577;132908;110824;3264;4163;129644;106661;41988;12584
Meißen;14,0;199321;205737;128305;104260;2606;3174;125699;101086;39018;12292
Sächsische Schweiz-Osterzgebirge;14,0;201720;206844;135002;111731;2860;3468;132142;108263;43478;13574
Leipzig, Stadt;14,0;454329;434618;279855;185252;3360;3382;276495;181870;42954;15277
Leipzig;14,0;213888;218976;132163;105298;2783;3096;129380;102202;32594;9171
Nordsachsen;14,0;162384;167553;94871;75879;2339;2553;92532;73326;24687;5957
Sachsen;99,0;3301120;3392983;2099660;1669244;39848;47487;2059812;1621757;520668;164263
Dessau-Roßlau, Stadt;15,0;66949;71682;36512;33690;798;859;35714;32831;7303;2689
Halle (Saale), Stadt;15,0;185329;190680;106938;77432;1561;1376;105377;76056;16930;5379
Magdeburg, Landeshauptstadt;15,0;188108;193706;102815;74684;1615;1533;101200;73151;16283;5063
Altmarkkreis Salzwedel;15,0;69354;73088;38977;33174;889;1062;38088;32112;6538;1622
Anhalt-Bitterfeld;15,0;135013;143863;71757;61292;1860;2275;69897;59017;15786;4761
Börde;15,0;142547;147327;76206;63238;1665;2382;74541;60856;15221;3274
Burgenlandkreis;15,0;148580;158118;82394;72570;2136;2462;80258;70108;19749;4813
Harz;15,0;182756;191721;97792;78141;2355;2534;95437;75607;17111;4123
Jerichower Land;15,0;75723;79325;41481;38036;1135;1405;40346;36631;7831;1850
Mansfeld-Südharz;15,0;115994;124226;62291;56178;1754;2231;60537;53947;15312;3284
Saalekreis;15,0;154540;161167;88259;72070;2306;2581;85953;69489;20915;4687
Salzlandkreis;15,0;161192;171435;80658;69598;2206;2607;78452;66991;16992;3559
Stendal;15,0;93514;97915;50842;41907;1044;1403;49798;40504;9638;2132
Wittenberg;15,0;106738;112612;61436;52604;1520;1899;59916;50705;13075;3369
Sachsen-Anhalt;99,0;1826337;1916865;998358;824614;22844;26609;975514;798005;198684;50605
Erfurt, Stadt;16,0;165659;167978;100627;80621;1454;1513;99173;79108;16672;5731
Gera, Stadt;16,0;76771;81727;43578;35553;702;837;42876;34716;12698;3875
Jena, Stadt;16,0;82364;84679;53518;44245;575;583;52943;43662;6738;2968
Suhl, Stadt;16,0;30717;33385;17351;15066;292;354;17059;14712;3146;1157
Weimar, Stadt;16,0;49921;50930;31460;25440;403;457;31057;24983;4350;1414
Eisenach, Stadt;16,0;33008;34353;19656;17736;315;319;19341;17417;3874;879
Eichsfeld;16,0;80973;83965;53326;48132;935;1208;52391;46924;9786;2775
Nordhausen;16,0;69807;72675;41083;35305;793;962;40290;34343;8992;1901
Wartburgkreis;16,0;98890;104301;61886;56774;1348;1680;60538;55094;13890;3460
Unstrut-Hainich-Kreis;16,0;84351;88204;50181;43760;1072;1302;49109;42458;11351;2607
Kyffhäuserkreis;16,0;63063;66767;37495;34500;1049;1164;36446;33336;8471;1636
Schmalkalden-Meiningen;16,0;104437;110551;63883;57607;1456;1757;62427;55850;13895;3728
Gotha;16,0;107910;112936;64599;58637;1409;1705;63190;56932;14385;4272
Sömmerda;16,0;57450;59940;35151;32190;828;1121;34323;31069;8493;2106
Hildburghausen;16,0;52476;55364;33914;29043;719;849;33195;28194;8030;1851
Ilm-Kreis;16,0;85619;89599;54305;47319;1113;1543;53192;45776;13419;4515
Weimarer Land;16,0;66547;68439;43772;38718;919;1143;42853;37575;10449;2797
Sonneberg;16,0;48378;51674;27807;24489;524;855;27283;23634;7206;1616
Saalfeld-Rudolstadt;16,0;88342;93580;53882;47555;1034;1405;52848;46150;14592;4107
Saale-Holzland-Kreis;16,0;68278;70654;45101;41321;1003;1171;44098;40150;10210;3920
Saale-Orla-Kreis;16,0;67029;71195;42514;38529;884;1181;41630;37348;11264;3114
Greiz;16,0;82940;88102;53197;48740;1139;1551;52058;47189;13297;4559
Altenburger Land;16,0;75936;80935;42954;39093;1053;1436;41901;37657;11371;3023
Thüringen;99,0;1740866;1821933;1071240;940373;21019;26096;1050221;914277;236579;68011
Bundesgebiet;;61600263;61998824;37807746;29843798;410857;488706;37396889;29355092;4104453;2070014
